13 49 0.25 0.4 5
XXXXXXXXXXXXXXXXXXXXXXXXXXXXXXXXXXXXXXXXXXXXXXXXX
X---X-----X-------------X---X-------X----------WX
X-X-X-XXX-XXX-XXX-X-XXXXX-X-X-XXX-X-XXX-X-XXX-XXX
X-X---X-X---X-X---X---X---X---X---X---X-X---X---X
X-XXX-X-XXX-X-X-XXXXX-X-XXXXX-X-XXXXX-X-XXX-XXX-X
X---X---X-X-X-X-X---X---X---X-X-X---X---X---X---X
X-X-XXX-X-X-XXX-X-X-XXXXX-X-XXX-X-X-XXXXX-XXX-XXX
X-X---X-X-X---X-X-X---X---X-X---X-X---X---X-X---X
X-X-X-X-X-XXX-X-X-XXX-X-XXX-X-XXX-XXXXX-XXX-X-X-X
X-X-X-X-X---X---X-X-X---X-X---X---X-----X-----X-X
X-X-XXX-X-X-XXXXX-X-XXXXX-XXXXX-X-X-XXXXXXXXXXX-X
XnX-------X-------X-------------X---------------X
XXXXXXXXXXXXXXXXXXXXXXXXXXXXXXXXXXXXXXXXXXXXXXXXX
