30 40 0.2 0.1 8
XXXXXXXXXXXXXXXXXXXXXXXXXXXXXXXXXXXXXXXX
X------------------S-------------------X
X--------------------------------------X
X--------------------------------------X
X--------------------------------------X
X--------------------------------------X
X--------------------------------------X
X--------------------------------------X
X--------------------------------------X
X--------------------------------------X
X--------------------------------------X
X--------------------------------------X
X--------------------------------------X
X--------------------------------------X
X--------------------------------------X
X--------------------------------------X
X--------------------------------------X
X--------------------------------------X
X--------------------------------------X
X--------------------------------------X
X--------------------------------------X
X--------------------------------------X
X--------------------------------------X
X--------------------------------------X
X--------------------------------------X
X--------------------------------------X
X--------------------------------------X
X--------------------------------------X
X-----------------n--------------------X
XXXXXXXXXXXXXXXXXXXXXXXXXXXXXXXXXXXXXXXX
