18 24 0.25 0.1 5
XXXXXXXXXXXXXXXXXXXXXXXX
X---------S------------X
X----------------------X
X----------------------X
X----------------------X
X----------------------X
X----------------------X
X----------------------X
X----------------------X
X----------------------X
Xe---------------------X
X----------------------X
X----------------------X
X----------------------X
X----------------------X
X----------------------X
X----------------------X
XXXXXXXXXXXXXXXXXXXXXXXX
