32 32 0.25 0.3 6
XXXXXXXXXXXXXXXXXXXXXXXXXXXXXXXX
XS-----------------------------X
X-XXXXXXXXXXXXXXXXXXXXXXXXXX-X-X
X-X------------------------X-X-X
X-X-XXXXXXXXXXXXXXXXXXXXXX-X-X-X
X-X-X--------------------X-X-X-X
X-X-X-XXXXXXXXXXXXXXXXXX-X-X-X-X
X-X-X-X----------------X-X-X-X-X
X-X-X-X-XXXXXXXXXXXXXX-X-X-X-X-X
X-X-X-X-X------------X-X-X-X-X-X
X-X-X-X-X-XXXXXXXXXX-X-X-X-X-X-X
X-X-X-X-X-X--------X-X-X-X-X-X-X
X-X-X-X-X-X-XXXXXX-X-X-X-X-X-X-X
X-X-X-X-X-X-X------X-X-X-X-X-X-X
X-X-X-X-X-X-X------X-X-X-X-X-X-X
X-X-X-X-X-X-X------X-X-X-X-X-X-X
X-X-X-X-X-X-X------X-X-X-X-X-X-X
X-X-X-X-X-X-X------X-X-X-X-X-X-X
X-X-X-X-X-X-X------X-X-X-X-X-X-X
X-X-X-X-X-X-X-XXXXXX-X-X-X-X-X-X
X-X-X-X-X-X-X--------X-X-X-X-X-X
X-X-X-X-X-X-XXXXXXXXXX-X-X-X-X-X
X-X-X-X-X-X------------X-X-X-X-X
X-X-X-X-X-XXXXXXXXXXXXXX-X-X-X-X
X-X-X-X-X----------------X-X-X-X
X-X-X-X-XXXXXXXXXXXXXXXXXX-X-X-X
X-X-X-X--------------------X-X-X
X-X-X-XXXXXXXXXXXXXXXXXXXXXX-X-X
X-X-X------------------------X-X
X-X-XXXXXXXXXXXXXXXXXXXXXXXXXX-X
X-----------------------------nX
XXXXXXXXXXXXXXXXXXXXXXXXXXXXXXXX
