30 40 0.15 0.4 1
XXXXXXXXXXXXXXXXXXXXXXXXXXXXXXXXXXXXXXXX
X--------------------------------------X
X--------------------------------------X
X--------------------------------------X
X-----------X--------------------------X
X-----------X--------------------------X
X-----------X--------------------------X
X-----------X--------------------------X
X-----------X-----------XXXXXXXXX------X
X-----------X----------XXXXXXXXXXX-----X
X-----------X-----------XXXXXXXXX------X
X-----------X--------------------------X
X--------------------------------------X
X--------------------------------------X
XXXXXXXXXXXXX--------------------------X
Xe-------------------------------------X
X--------------------------------------X
X--------------------------------------X
X--------------------------------------X
X------------------------X-------------X
X------------------------X-------------X
X------------------------X-------------X
X----XXXXXXXXXX----------X-------------X
X------------------------X-------------X
X------------------------X-------------X
X--------------------------------------X
X--------------------------------------X
X----------------------------XXXXXXXXXXX
X-------------------------------------WX
XXXXXXXXXXXXXXXXXXXXXXXXXXXXXXXXXXXXXXXX
